The	DEF
report	CON
comes	ENS
as	SUB
Afghan	GPE
officials	CON
announced	PST
that	SUB
the	DEF
bodies	CON
of	REL
20	DOM
Taleban	ORG
militants	CON
had	EPT
been	ETV
recovered	EXV
from	REL
Bermel	LOC
district	CON
in	REL
Paktika	LOC
province	CON
,	NIL
where	PRO
NATO	ORG
and	AND
Afghan	GPE
forces	CON
recently	REL
conducted	PST
a	DIS
mission	CON
.	NIL

Turkish	GPE
Prime~Minister	UNK
Tayyip	PER
Erdogan	PER
,	NIL
in	REL
London	LOC
for	REL
talks	CON
with	REL
British	GPE
Prime~Minister	UNK
Tony	PER
Blair	PER
,	NIL
said	PST
Wednesday	TIM
Ankara	TIM
would	FUT
sign	EXS
the	DEF
EU	ORG
protocol	CON
soon	REL
.	NIL
